𱍐	mmlc
𱍑	gi
𱍒	mnlbk
𱍓	kqq
𱍔	myikp
𱍕	mfoo
𱍖	tmmy
𱍗	mece
𱍘	hiph
𱍙	fbmn
𱍚	mfnh
𱍛	mfor
𱍜	crmy
𱍝	jumy
𱍞	lmmo
𱍟	ymonp
𱍠	rrry
𱍡	mflsb
𱍢	mrnnn
𱍣	kgmgi
𱍤	mfao
𱍥	tlpm
𱍦	ptybs
𱍧	simy
𱍨	tomfm
𱍩	ymmzb
𱍪	mbixe
𱍫	svs
𱍬	link
𱍭	liav
𱍮	liyiu
𱍯	libmr
𱍰	llml
𱍱	libtu
𱍲	lihab
𱍳	lita
𱍴	litgv
𱍵	litxc
𱍶	liipf
𱍷	lie
𱍸	hv
𱍹	nhi
𱍺	ots
𱍻	iom
𱍼	olhsm
𱍽	mbino
𱍾	eogo
𱍿	lvno
𱎀	ns
𱎁	smf
𱎂	kny
𱎃	nenh
𱎄	nfs
𱎅	nher
𱎆	nnbq
𱎇	nlsy
𱎈	ndbu
𱎉	nsjl
𱎊	hfn
𱎋	niil
𱎌	nydl
𱎍	nebg
𱎎	ern
𱎏	fkpd
𱎐	yvn
𱎑	jdhoe
𱎒	mgbm
𱎓	mkkk
𱎔	iripm
𱎕	mggg
𱎖	mdmb
𱎗	ifipm
𱎘	yit
𱎙	yufhu
𱎚	hk
𱎛	og
𱎜	omy
𱎝	oyv
𱎞	oslm
𱎟	onhh
𱎠	tot
𱎡	obo
𱎢	oynn
𱎣	ooo
𱎤	ohn
𱎥	ohm
𱎦	oyml
𱎧	ondu
𱎨	oom
𱎩	ootn
𱎪	oeq
𱎫	oml
𱎬	oou
𱎭	ovnd
𱎮	omw
𱎯	orbo
𱎰	oag
𱎱	oyvp
𱎲	oudhe
𱎳	oxb
𱎴	obtv
𱎵	oahg oamg
𱎶	oukd
𱎷	xpoo
𱎸	oyhl
𱎹	otge
𱎺	ondt
𱎻	odnz
𱎼	otlj
𱎽	ohae
𱎾	ofsm
𱎿	omia omla
𱏀	omlp
𱏁	otoi
𱏂	otcl
𱏃	oiib oivb
𱏄	obkr
𱏅	ogrm
𱏆	obov
𱏇	ordk
𱏈	ohjz
𱏉	ompsh
𱏊	oykm
𱏋	oiku
𱏌	otpi
𱏍	oshn
𱏎	jdoln
𱏏	wgomd
𱏐	ofbo
𱏑	oxpf
𱏒	ocno
𱏓	olsw
𱏔	odlo
𱏕	ohzv
𱏖	oxws
𱏗	ordhe
𱏘	ordj
𱏙	ordf
𱏚	onqp
𱏛	ordo
𱏜	ohbs
𱏝	ohud
𱏞	oxhc
𱏟	ordc
𱏠	olts
𱏡	ohqc
𱏢	ooip
𱏣	ovfi
𱏤	mffu
𱏥	iihu
𱏦	fuyt
𱏧	ihhu
𱏨	yzru
𱏩	fuopj
𱏪	tzuku
𱏫	lpbhu
𱏬	ybrhu
𱏭	ahfu
𱏮	fciib fciiu
𱏯	wrhgu
𱏰	fumzw
𱏱	olis
𱏲	orau
𱏳	ycy
𱏴	ttc
𱏵	iomc
𱏶	bcjr
𱏷	tctc
𱏸	ciytb
𱏹	bq
𱏺	tb
𱏻	bie
𱏼	ihmb
𱏽	bmue
𱏾	bddw
𱏿	imr
𱐀	imbo
𱐁	imynn
𱐂	imniy
𱐃	imluo
𱐄	imrbo
𱐅	imbuc
𱐆	imhgr imhqr
𱐇	immz
𱐈	immki
𱐉	imfq
𱐊	imytu
𱐋	immxf
𱐌	imgrr
𱐍	ufd
𱐎	urob
𱐏	omju
𱐐	uxrsn
𱐑	uusuu
𱐒	mysln
𱐓	shcsh
𱐔	sksk
𱐕	shshh
𱐖	sham
𱐗	shos
𱐘	mmoln
𱐙	ythln
𱐚	lwsln
𱐛	bvln
𱐜	ykqn
𱐝	mtuln
𱐞	ymsh
𱐟	yojln
𱐠	ikhln
𱐡	tmsh
𱐢	bffln
𱐣	nlmln
𱐤	tmjln
𱐥	doeln
𱐦	icrln idrln
𱐧	onyr
𱐨	tnwhr
𱐩	oks
𱐪	lsks
𱐫	ksmr
𱐬	ptks
𱐭	ptks
𱐮	bqks
𱐯	ksjp
𱐰	ksjru
𱐱	jmks
𱐲	nsdks
𱐳	jllks
𱐴	krkb
𱐵	jiiks
𱐶	kswld
𱐷	ihnhs
𱐸	puoy
𱐹	phhi
𱐺	phhf
𱐻	puhbq
𱐼	phwmv
𱐽	tapi tapm
𱐾	sfphh
𱐿	phbbe
𱑀	phho
𱑁	phjf
𱑂	phhz
𱑃	puowa
𱑄	pvvu
𱑅	pkomd
𱑆	smgk
𱑇	sgfu
𱑈	washl
𱑉	syjo
𱑊	siml
𱑋	seor
𱑌	stkp
𱑍	srgrw
𱑎	yzj
𱑏	lcq
𱑐	ymoj
𱑑	suokk
𱑒	ojkha
𱑓	jrwj
𱑔	slmj
𱑕	ytbj
𱑖	ybrr
𱑗	rbcy
𱑘	ipl
𱑙	slapv
𱑚	hvsln
𱑛	vghvl
𱑜	mje
𱑝	mmcw
𱑞	mtjb
𱑟	mdbm
𱑠	mrhu
𱑡	mfnmu
𱑢	in
𱑣	gicl
𱑤	gix
𱑥	bogi
𱑦	gilwp
𱑧	iehr
𱑨	igik
𱑩	girno
𱑪	giyki
𱑫	gijhr
𱑬	gihdn
𱑭	gismi
𱑮	ibgi
𱑯	ihhli
𱑰	gijrw
𱑱	em
𱑲	bme
𱑳	ey
𱑴	hre
𱑵	esr
𱑶	eene
𱑷	omde
𱑸	fbe
𱑹	hpe
𱑺	ffe
𱑻	herhr herr
𱑼	liyue
𱑽	huwe
𱑾	fbere
𱑿	rps
𱒀	rms
𱒁	rtn
𱒂	rnhh
𱒃	rf
𱒄	rru
𱒅	ru
𱒆	rmk
𱒇	rynn
𱒈	ra
𱒉	run
𱒊	romm
𱒋	kkr
𱒌	rhul
𱒍	kjr
𱒎	ree
𱒏	ssr
𱒐	rih
𱒑	mobr
𱒒	rbu
𱒓	remn
𱒔	rmgi
𱒕	mre
𱒖	rdy
𱒗	rmhn
𱒘	rmgn
𱒙	rkmj
𱒚	rjlk
𱒛	rryv
𱒜	rfk
𱒝	rhes
𱒞	rkd
𱒟	rohl
𱒠	rbks
𱒡	rtlb
𱒢	yzr
𱒣	ryks
𱒤	rvvn
𱒥	rvr
𱒦	rqki
𱒧	rqse
𱒨	rsok
𱒩	rdhh
𱒪	rkq
𱒫	rqdk
𱒬	rqoy
𱒭	mlnr
𱒮	qdir
𱒯	ryws
𱒰	rtdi
𱒱	omdr
𱒲	rows
𱒳	rkhg
𱒴	rojr
𱒵	rhoe
𱒶	rlsp
𱒷	qgrp
𱒸	rlsh
𱒹	rene
𱒺	rex
𱒻	rnpo
𱒼	rnhw
𱒽	rdmf
𱒾	rdf
𱒿	rdhp
𱓀	rymt
𱓁	rtkc
𱓂	rrmr
𱓃	wlor
𱓄	rthn
𱓅	rhjp
𱓆	rnea
𱓇	rbpu
𱓈	rbhg
𱓉	rpma
𱓊	rogg
𱓋	rotc
𱓌	ryho
𱓍	rhub
𱓎	krtr
𱓏	rlsh
𱓐	rjyk
𱓑	lhrr
𱓒	rilo
𱓓	rphn
𱓔	rwjo
𱓕	rven
𱓖	rdyb
𱓗	rmbi
𱓘	rmee
𱓙	rqgi
𱓚	rrrm
𱓛	ral
𱓜	rthy
𱓝	rllo
𱓞	royr
𱓟	rbfq
𱓠	roro
𱓡	rhan
𱓢	rbhm
𱓣	rtol
𱓤	riuu
𱓥	rlsk
𱓦	reor
𱓧	rtol
𱓨	rndd
𱓩	rnok
𱓪	rsqmb
𱓫	rdtq
𱓬	rykb
𱓭	rdks
𱓮	rqlb
𱓯	rdyo
𱓰	rqkf
𱓱	jrlh
𱓲	rtbd
𱓳	rwlx
𱓴	rttc
𱓵	rcsl
𱓶	rogp
𱓷	rhdh
𱓸	rcmn
𱓹	rowd
𱓺	rokr
𱓻	rhrb
𱓼	rcj
𱓽	ryzp
𱓾	rimw
𱓿	rejd
𱔀	rihn
𱔁	rpoy
𱔂	ryoe
𱔃	rvch
𱔄	rqor
𱔅	rqku
𱔆	rrbhr
𱔇	raib
𱔈	rrmtt
𱔉	ryyj
𱔊	rlec
𱔋	orumr
𱔌	rhip
𱔍	rxau
𱔎	rowv
𱔏	rhdn
𱔐	hkr ikr
𱔑	rpih
𱔒	ryre
𱔓	rjkr
𱔔	rwjc
𱔕	rvfw
𱔖	irjr
𱔗	rmnv
𱔘	rdre
𱔙	rjdy
𱔚	rtpd
𱔛	fufur
𱔜	rrsl
𱔝	rlir
𱔞	rrttv
𱔟	rbfs
𱔠	rnao
𱔡	rhon
𱔢	rkha
𱔣	rjrn
𱔤	rjcl
𱔥	rtck rtwk
𱔦	rebn
𱔧	ryrs
𱔨	ryxv
𱔩	rcji
𱔪	rykg
𱔫	rjcr
𱔬	reet
𱔭	ryzi
𱔮	rtgo
𱔯	rsnd
𱔰	rnxu
𱔱	urwn
𱔲	rvfr
𱔳	grcsh
𱔴	rmzi rmzl
𱔵	rdup
𱔶	rdmm
𱔷	rmok
𱔸	rqwt
𱔹	rdfv
𱔺	rmzn
𱔻	rtrk
𱔼	rrxz
𱔽	ryeu
𱔾	rbug
𱔿	rnbi
𱕀	rjcd
𱕁	rebk
𱕂	nurp
𱕃	ryre
𱕄	rvdn
𱕅	rmda
𱕆	rmwr
𱕇	rdte
𱕈	rtag
𱕉	rwdv
𱕊	rylr
𱕋	rhbt
𱕌	rhwn
𱕍	rhtz
𱕎	hrlwv
𱕏	oysvr
𱕐	rjsh
𱕑	ryar
𱕒	ryry
𱕓	mvrkk
𱕔	rstp
𱕕	rqne
𱕖	rdqa
𱕗	rqoj
𱕘	rfof
𱕙	rrxf
𱕚	rooo
𱕛	remj
𱕜	rijb
𱕝	rdca
𱕞	geher
𱕟	rdtc
𱕠	rdkx
𱕡	gamr
𱕢	rhll
𱕣	ryra
𱕤	rnlo
𱕥	rsfi
𱕦	rtjg
𱕧	rsef
𱕨	rtkq
𱕩	csrp
𱕪	rqwp
𱕫	ryvn
𱕬	ryrk
𱕭	totlo
𱕮	rddq
𱕯	rkuz
𱕰	rykq rynq
𱕱	rsjp
𱕲	rtvt
𱕳	ryuu
𱕴	mromr
𱕵	rjmto
𱕶	rrhjg
𱕷	rnuu
𱕸	wdb
𱕹	wpru
𱕺	wli
𱕻	wiki
𱕼	wlo
𱕽	whbv
𱕾	ppwr
𱕿	wcor
𱖀	whua
𱖁	wvmn
𱖂	wre
𱖃	wtcu
𱖄	whsw
𱖅	mfwo
𱖆	bg
𱖇	gmj
𱖈	gmu
𱖉	vvg
𱖊	gfh
𱖋	opg
𱖌	ohg
𱖍	gci
𱖎	ghk
𱖏	gosu
𱖐	ykg
𱖑	gss
𱖒	giq
𱖓	mgg
𱖔	umg
𱖕	grc
𱖖	gxu
𱖗	nyg
𱖘	ghey
𱖙	gou
𱖚	nfg
𱖛	goym
𱖜	geg
𱖝	gmgb
𱖞	gklg
𱖟	gsmg
𱖠	qpg
𱖡	gkdi
𱖢	gfhs
𱖣	lileg
𱖤	gohg gomg
𱖥	gnau
𱖦	oog
𱖧	giml
𱖨	gyhv
𱖩	gyks
𱖪	kog
𱖫	gmoo
𱖬	gdt
𱖭	gmbo
𱖮	gwd
𱖯	gwcb
𱖰	gbv
𱖱	gkkb
𱖲	glsa
𱖳	gbcm
𱖴	gbbm
𱖵	slg
𱖶	geg
𱖷	gsmi
𱖸	kjt
𱖹	gdoo
𱖺	gwmg
𱖻	yacg
𱖼	gbok
𱖽	glp
𱖾	glsy
𱖿	lgyy
𱗀	gomu
𱗁	oug
𱗂	gomr
𱗃	ghua
𱗄	qqg
𱗅	gkkb
𱗆	gojk
𱗇	igg
𱗈	ttg
𱗉	gycv
𱗊	gnlr
𱗋	gtlj
𱗌	gdln
𱗍	gmfj
𱗎	guv
𱗏	gliu
𱗐	wgcg
𱗑	gaos
𱗒	gypm
𱗓	lgee
𱗔	gnsp
𱗕	hfg
𱗖	gcrp
𱗗	gil
𱗘	nqg
𱗙	grse
𱗚	gnis
𱗛	gksi
𱗜	gmvr
𱗝	gsje
𱗞	gbbb
𱗟	gwoi gwol
𱗠	gypp
𱗡	gypk
𱗢	gafu
𱗣	cisg
𱗤	ghaj
𱗥	ghyv
𱗦	gbhv
𱗧	esg
𱗨	gyzp
𱗩	gyav
𱗪	qug
𱗫	gmzs
𱗬	klgy
𱗭	gltl
𱗮	gype
𱗯	godj
𱗰	ghhu
𱗱	gbrh
𱗲	ghyr
𱗳	ylg
𱗴	gfmgg
𱗵	mog
𱗶	gqoa
𱗷	aaag
𱗸	gase
𱗹	ganp
𱗺	gxpf
𱗻	gwff
𱗼	hgmgt
𱗽	gyog
𱗾	fgsly
𱗿	gjao
𱘀	gybk
𱘁	yug
𱘂	vbg
𱘃	gllc
𱘄	tkg
𱘅	grxr
𱘆	gnbq
𱘇	gyhu
𱘈	erg
𱘉	gitc
𱘊	gfvk
𱘋	gjuu
𱘌	lghdo
𱘍	glyv
𱘎	gcav
𱘏	gjwc
𱘐	gytg
𱘑	gjbf
𱘒	gysl
𱘓	gwgf
𱘔	gnlq
𱘕	gqbd
𱘖	rrgle
𱘗	ghyu ghyv
𱘘	ganw
𱘙	egg
𱘚	plg
𱘛	gfff
𱘜	tsg
𱘝	getg
𱘞	gvfd
𱘟	gmzo
𱘠	ghyoj
𱘡	gtmfm
𱘢	ghjbf
𱘣	heosl heoni
𱘤	mbhe
𱘥	uche
𱘦	nish
𱘧	odhee
𱘨	jmnin
𱘩	ykiyr
𱘪	bunin
𱘫	lgue
𱘬	mktwn
𱘭	kp
𱘮	kys
𱘯	mrk
𱘰	kfk
𱘱	mtk
𱘲	kwks
𱘳	oek
𱘴	ktnhe
𱘵	kykr
𱘶	mkpha
𱘷	mkomn
𱘸	kmil kmvl
𱘹	jjkq
𱘺	kogis
𱘻	huk
𱘼	ksajv
𱘽	ttk
𱘾	knfd
𱘿	vfk
𱙀	kpdc
𱙁	vm
𱙂	vhu
𱙃	vvv
𱙄	vysm
𱙅	vlis
𱙆	vno
𱙇	vop
𱙈	voj
𱙉	ohv
𱙊	skv
𱙋	vys
𱙌	vwc
𱙍	veg
𱙎	mlv
𱙏	vwk
𱙐	vx
𱙑	vykl
𱙒	vlsd
𱙓	vjmd
𱙔	vmlh
𱙕	vag
𱙖	vcor
𱙗	vlsb
𱙘	euv
𱙙	vsf
𱙚	vxo
𱙛	vyrd
𱙜	spvnd
𱙝	vrsj
𱙞	vypm
𱙟	vtcl
𱙠	viji
𱙡	vthb vtmb
𱙢	vqbv
𱙣	vuhj
𱙤	vtod
𱙥	vyzp
𱙦	vibp
𱙧	vypl vypm
𱙨	vtpb
𱙩	vhce
𱙪	vjfr
𱙫	vjmc
𱙬	vejbl
𱙭	vmog
𱙮	vtbd
𱙯	vmtb
𱙰	vybo
𱙱	vsjt
𱙲	lqnqv
𱙳	jvtpb
𱙴	vtgo
𱙵	ndu
𱙶	kind
𱙷	ndbo
𱙸	ndob
𱙹	nduu
𱙺	ndop
𱙻	dtnd
𱙼	gobd
𱙽	ndtob
𱙾	qdrms
𱙿	ndjmo
𱚀	ndmzw
𱚁	ndytp
𱚂	jnda
𱚃	jmy
𱚄	jndu
𱚅	jksr
𱚆	jmfp
𱚇	jbuc
𱚈	jug
𱚉	jwd
𱚊	jbqr
𱚋	jhwj
𱚌	jre
𱚍	jrrn
𱚎	jyln
𱚏	jsqf
𱚐	joge
𱚑	oqjbm
𱚒	jjii
𱚓	jua
𱚔	jxvv
𱚕	jlx
𱚖	jenef
𱚗	jhwf
𱚘	jhaj
𱚙	jpha
𱚚	jmor
𱚛	shjtu
𱚜	jhbt
𱚝	cshi
𱚞	hai
𱚟	dedi
𱚠	mbdi
𱚡	togi
𱚢	bbdi
𱚣	fhpi fhpm
𱚤	fuu
𱚥	flsh
𱚦	fmws
𱚧	ymsf
𱚨	fkjwl
𱚩	eaf
𱚪	fhdg
𱚫	fhog
𱚬	fkccu
𱚭	ybk
𱚮	mkmuh
𱚯	muvsu
𱚰	sj
𱚱	sdi
𱚲	smy
𱚳	sfh
𱚴	sng
𱚵	shqo
𱚶	sksr
𱚷	shrr
𱚸	syhv
𱚹	sobm
𱚺	sbv
𱚻	shod
𱚼	sdbm
𱚽	spju
𱚾	sutw
𱚿	sbwl
𱛀	syapv
𱛁	sufbg
𱛂	suile
𱛃	sqsqq
𱛄	pukld
𱛅	liu
𱛆	unn
𱛇	uysm
𱛈	mmiu
𱛉	umsu
𱛊	ubhu
𱛋	uob
𱛌	uonh
𱛍	uop
𱛎	uphh
𱛏	upo
𱛐	unl
𱛑	udk
𱛒	undu
𱛓	uikp
𱛔	ugi
𱛕	uklb
𱛖	uwl
𱛗	uux
𱛘	uhio
𱛙	uhvd
𱛚	uhes
𱛛	omu
𱛜	uklg
𱛝	uml
𱛞	ummn
𱛟	umik
𱛠	ukf
𱛡	ukms
𱛢	urr
𱛣	ufg
𱛤	uwk
𱛥	uhgu
𱛦	uiuj
𱛧	uvnd
𱛨	umbo
𱛩	udl
𱛪	uuf
𱛫	ubuc
𱛬	uadi
𱛭	ubdi
𱛮	unbg unbq
𱛯	ucru
𱛰	usf
𱛱	ugl
𱛲	umgk
𱛳	uumr
𱛴	unwm
𱛵	upou
𱛶	uhog
𱛷	ummo
𱛸	uqka
𱛹	usjl
𱛺	udl
𱛻	utlk
𱛼	uhoq
𱛽	uhje
𱛾	uyzn
𱛿	uegg
𱜀	unis
𱜁	ufih
𱜂	wnue
𱜃	upuu
𱜄	uckc
𱜅	utwa
𱜆	uypr
𱜇	uolo
𱜈	uhfp
𱜉	uyhj
𱜊	unwf
𱜋	uybu
𱜌	ufym
𱜍	uomw
𱜎	ukhw
𱜏	uhlq
𱜐	hku
𱜑	uhjf
𱜒	nqu
𱜓	uhbu
𱜔	uhgb
𱜕	uqmw
𱜖	vdid
𱜗	rrss
𱜘	obss
𱜙	ssob
𱜚	mowks
𱜛	ssbv
𱜜	okfs
𱜝	sspc
𱜞	augce
𱜟	tubk
𱜠	auoo
𱜡	kbss
𱜢	tlb
𱜣	tlb
𱜤	lbkt
𱜥	lbhby
𱜦	ymcb
𱜧	xpmlb
𱜨	hiklb
𱜩	lbfqn
𱜪	lbhab
𱜫	hoybn
𱜬	lbyrf
𱜭	lbsuu
𱜮	kbijb
𱜯	lbhsb lbisb
𱜰	lbhqu
𱜱	lbyzk
𱜲	bljlb
𱜳	lbanu
𱜴	lbyub
𱜵	lbjwp
𱜶	xpybb
𱜷	hekb
𱜸	lbybo
𱜹	mosbb
𱜺	lbqoc
𱜻	lbrrr
𱜼	lbybp
𱜽	mjrsn
𱜾	mjyrv
𱜿	gldok
𱝀	hhhhc tttxc
𱝁	glgwg
𱝂	oqase
𱝃	imcw
𱝄	ife
𱝅	itf
𱝆	ikit
𱝇	iydl
𱝈	itbb
𱝉	inip
𱝊	ikcf
𱝋	ifq
𱝌	imtz
𱝍	inli
𱝎	giixf
𱝏	imfdq
𱝐	gtixf
𱝑	neho
𱝒	netw
𱝓	nemfx
𱝔	qkt
𱝕	ift
𱝖	mttgm
𱝗	yut
𱝘	csht
𱝙	nl
𱝚	nci
𱝛	cin
𱝜	nys
𱝝	nwg
𱝞	nwmi
𱝟	se
𱝠	snib
𱝡	rmpn
𱝢	gghhh
𱝣	bbhh
𱝤	wihhh
𱝥	ydlh
𱝦	ihhhh
𱝧	bnhhq
𱝨	lpnhh
𱝩	buhhp
𱝪	hoo
𱝫	hoym
𱝬	hohn
𱝭	hojb
𱝮	hooks
𱝯	hohhv
𱝰	homlb
𱝱	hohbn
𱝲	hohsk hoisk homsk
𱝳	hoikh
𱝴	hojrb
𱝵	horrr
𱝶	hougi
𱝷	hooar
𱝸	hiomd
𱝹	hoypo
𱝺	hohxb
𱝻	hchhe
𱝼	vp
𱝽	pe
𱝾	hpp
𱝿	ikp
𱞀	pnd
𱞁	psu
𱞂	mgp
𱞃	opp
𱞄	pp
𱞅	piks
𱞆	ngp
𱞇	pvis
𱞈	pmun
𱞉	ptp
𱞊	pymy
𱞋	pys
𱞌	phio
𱞍	bqp
𱞎	imp
𱞏	pksr
𱞐	pvvu
𱞑	phbm
𱞒	phes poks
𱞓	eop
𱞔	pvmi
𱞕	psdi
𱞖	vjp
𱞗	pmmv
𱞘	pmmd
𱞙	pmcw
𱞚	phvf
𱞛	phqi
𱞜	hwp
𱞝	sktp
𱞞	pahl
𱞟	pllc
𱞠	pleo
𱞡	hip
𱞢	ppou
𱞣	poyv
𱞤	pyon
𱞥	ikwp
𱞦	ptge
𱞧	pihi
𱞨	psbb
𱞩	prme
𱞪	pihv
𱞫	pdwf
𱞬	pdam pdbm
𱞭	ptw
𱞮	payt
𱞯	pal
𱞰	pyrr
𱞱	oftp
𱞲	omp
𱞳	plvu
𱞴	pkhv
𱞵	nnpm
𱞶	pfbu
𱞷	pybb
𱞸	ptgk
𱞹	lsnin
𱞺	pvfi pvfm
𱞻	pneq
𱞼	drp
𱞽	pkrb
𱞾	pqjv
𱞿	pbmo
𱟀	pysl
𱟁	pold
𱟂	pffj
𱟃	pebd
𱟄	pyrb
𱟅	ipirp
𱟆	pqpg
𱟇	pjbp
𱟈	pxxx
𱟉	pthb
𱟊	prrs
𱟋	plyk
𱟌	pfbu
𱟍	ylp
𱟎	pcji
𱟏	pesd
𱟐	pdkh
𱟑	pnxl
𱟒	pghz
𱟓	phfp
𱟔	hgonp
𱟕	phmt
𱟖	npjhr
𱟗	piwd
𱟘	pbop
𱟙	npixp
𱟚	pogr
𱟛	pbmip
𱟜	sbi
𱟝	jji
𱟞	ximbu
𱟟	sri
𱟠	ugi
𱟡	ybypi
𱟢	hssc issc
𱟣	hbph ibph mbph
𱟤	tqhss
𱟥	hjapp ijapp
𱟦	yqhss
𱟧	hsyhj
𱟨	yqiss
𱟩	qysm
𱟪	qf
𱟫	qhhh
𱟬	qsim
𱟭	qmf
𱟮	qlwu
𱟯	qllb
𱟰	qde
𱟱	qw
𱟲	qotn
𱟳	qots
𱟴	qkbi
𱟵	qihq
𱟶	qkui
𱟷	mwq
𱟸	qybo
𱟹	qqme
𱟺	qrhl
𱟻	qryo
𱟼	qlws
𱟽	qrob
𱟾	qokh
𱟿	qhmn
𱠀	qow
𱠁	qbru
𱠂	qoe
𱠃	qeoi qeol
𱠄	qbcj
𱠅	qyr
𱠆	qykq
𱠇	qdok
𱠈	qdmf
𱠉	qjln
𱠊	qwhy
𱠋	apdh
𱠌	qwln
𱠍	qthn
𱠎	qlqc
𱠏	qjcu
𱠐	qoot
𱠑	qonp
𱠒	qhss qiss
𱠓	qysk
𱠔	qfsu
𱠕	qmbv
𱠖	qmae
𱠗	qmee
𱠘	qnmlk
𱠙	qwlp
𱠚	qal
𱠛	qhdl
𱠜	qybn qybu
𱠝	qytk
𱠞	qyta
𱠟	qnmsu
𱠠	qmbp
𱠡	qlkt
𱠢	qhup
𱠣	qcn
𱠤	ehqi
𱠥	qylo
𱠦	qpf
𱠧	qyzd
𱠨	qjfb
𱠩	qgyr
𱠪	qaop
𱠫	qorr
𱠬	qhjz
𱠭	qhyt
𱠮	qhce
𱠯	qnlu
𱠰	qvmu
𱠱	qjtc
𱠲	qjii
𱠳	qwgg
𱠴	qfhi
𱠵	qyni
𱠶	qjpb
𱠷	qykg
𱠸	qvmo
𱠹	quun
𱠺	qtkp
𱠻	qatv
𱠼	qyro
𱠽	qnzz
𱠾	qmtl
𱠿	qteb
𱡀	qiwf
𱡁	qyar
𱡂	qvfj
𱡃	qslv
𱡄	qkma
𱡅	qwfg
𱡆	qypp
𱡇	qhqy
𱡈	qyld
𱡉	qjhw
𱡊	qnrj
𱡋	qshe
𱡌	qmha
𱡍	qyvg
𱡎	qhwi
𱡏	qsrq
𱡐	qanw
𱡑	qitr
𱡒	qyck
𱡓	qumrr
𱡔	qybm
𱡕	qfkf
𱡖	qvfd
𱡗	ksje
𱡘	dtok
𱡙	mxye
𱡚	gjpk
𱡛	gcgok
𱡜	wmlok
𱡝	annok
𱡞	madok
𱡟	bmeok
𱡠	ogrok
𱡡	fdybe
𱡢	yklb
𱡣	yklba
𱡤	ykjbm
𱡥	ykhsl
𱡦	yksuu
𱡧	ykxbf
𱡨	ioyj
𱡩	rghml
𱡪	hphml
𱡫	xphml
𱡬	clklb
𱡭	hkhml
𱡮	vchml
𱡯	mbhml
𱡰	mlhss
𱡱	ysfh
𱡲	ysoju
𱡳	ysol
𱡴	ysthq
𱡵	tqyhs
𱡶	ysogg
𱡷	yscwa
𱡸	ysoih
𱡹	lal
𱡺	aje
𱡻	aon
𱡼	aiks
𱡽	ayg
𱡾	arup
𱡿	ama
𱢀	amph
𱢁	auni
𱢂	atq
𱢃	akhf
𱢄	ahmc
𱢅	ahsu
𱢆	aomd
𱢇	anlm
𱢈	aiok
𱢉	aqmv
𱢊	asly
𱢋	ahdd
𱢌	aonp
𱢍	ajrr
𱢎	alsh
𱢏	aihv
𱢐	adiu
𱢑	gagi
𱢒	athv
𱢓	aqlp
𱢔	awp
𱢕	aabu
𱢖	acst
𱢗	anoo
𱢘	ansp
𱢙	asje
𱢚	aano
𱢛	amsp
𱢜	ajqr
𱢝	ayon
𱢞	aiib amib
𱢟	aihn
𱢠	anld
𱢡	ahmam
𱢢	atvg
𱢣	alcq
𱢤	aanh
𱢥	agiu
𱢦	adbb
𱢧	aoyhl
𱢨	augk
𱢩	ahor
𱢪	aogd
𱢫	aogs
𱢬	otfa
𱢭	amco
𱢮	aypo
𱢯	tda
𱢰	auwf
𱢱	ayls
𱢲	ahbs
𱢳	hupa
𱢴	ajoo
𱢵	twtjr
𱢶	aeir
𱢷	oagb
𱢸	oib olb
𱢹	bgg
𱢺	kbfd
𱢻	bobp
𱢼	btyt
𱢽	juybg
𱢾	dp
𱢿	dno
𱣀	jed
𱣁	dmni
𱣂	dhvm
𱣃	dhnq
𱣄	diks
𱣅	ykd
𱣆	dmr
𱣇	dl
𱣈	dlbe
𱣉	doom
𱣊	dhvl
𱣋	denl
𱣌	dnhd
𱣍	sjd
𱣎	qqd
𱣏	dtk
𱣐	dbon
𱣑	dobo
𱣒	hnd
𱣓	domh
𱣔	donq
𱣕	dox
𱣖	dfc
𱣗	dyz
𱣘	dei
𱣙	dgyo
𱣚	dmbo
𱣛	dgug
𱣜	dqmu
𱣝	drau
𱣞	drbo
𱣟	dxo
𱣠	dhrm
𱣡	dlsd
𱣢	djki
𱣣	dyvd
𱣤	dlsa
𱣥	dkjt
𱣦	kbdl
𱣧	dggy
𱣨	ddhnq
𱣩	dthq
𱣪	dtau
𱣫	doot
𱣬	ykd
𱣭	dysd
𱣮	depu
𱣯	djlw
𱣰	degi
𱣱	dwjo
𱣲	dnlr
𱣳	dqen
𱣴	dmnj
𱣵	dnrm
𱣶	dwii
𱣷	drli
𱣸	dtys
𱣹	dhoa dhya
𱣺	djcl
𱣻	dkro
𱣼	dnhn
𱣽	dmnf
𱣾	dmti
𱣿	dthr
𱤀	dtqd
𱤁	dtnu
𱤂	dtfb
𱤃	ked
𱤄	dokr
𱤅	kdaph
𱤆	doyr
𱤇	dehv
𱤈	ddpmi
𱤉	mkdl
𱤊	bvd
𱤋	dais
𱤌	dubb
𱤍	dorw
𱤎	dvfy dvfm
𱤏	dddd
𱤐	djit
𱤑	dtnew
𱤒	jdtak
𱤓	dmru
𱤔	dtee
𱤕	dtkt
𱤖	dxii
𱤗	drimo
𱤘	dhbo
𱤙	dfff
𱤚	dlsw
𱤛	dviu
𱤜	qdcwa
𱤝	dyed
𱤞	dypb
𱤟	dtav
𱤠	krqu
𱤡	drxi
𱤢	uobd
𱤣	doqc
𱤤	debu
𱤥	dysq
𱤦	jbhld
𱤧	gahjd
𱤨	dhnx
𱤩	dhyj
𱤪	dhwv
𱤫	dslv
𱤬	dsec
𱤭	dihd
𱤮	dgif dgkf
𱤯	drrr
𱤰	dhkp
𱤱	drrr
𱤲	dhhz
𱤳	dtmm
𱤴	hdjhw
𱤵	dorp
𱤶	dxbf
𱤷	sjnlo
𱤸	wbno
𱤹	nmnmo
𱤺	ioioo momoo
𱤻	xz
𱤼	xmn
𱤽	mx
𱤾	xon
𱤿	inx
𱥀	xoe
𱥁	xshr
𱥂	mxmx
𱥃	xnohh
𱥄	xybn
𱥅	tux
𱥆	shqx
𱥇	mwkx
𱥈	boxe
𱥉	xpytp
𱥊	hnx
𱥋	mnin
𱥌	yyye
𱥍	xnms
𱥎	mpir
𱥏	mnyaj
𱥐	mnorl
𱥑	mnbgr mnbqr
𱥒	mnjrb
𱥓	mndmq
𱥔	mntmt
𱥕	takp
𱥖	gnhne
𱥗	jdhne
𱥘	qlkde
𱥙	tghne
𱥚	tchne
𱥛	jdwy
𱥜	huby
𱥝	qwoyk
𱥞	humob
𱥟	huiu
𱥠	kthqu
𱥡	hvhqu
𱥢	huqka
𱥣	hutkr
𱥤	huytu
𱥥	iphqu
𱥦	wlhqu
𱥧	hutwv
𱥨	ruiq
𱥩	surup
𱥪	onkkb
𱥫	onytr
𱥬	yion
𱥭	odqmb
𱥮	hd
𱥯	oe
𱥰	ecl
𱥱	es
𱥲	ekb
𱥳	emml
𱥴	eqi
𱥵	ebk
𱥶	eynn
𱥷	cse
𱥸	eoy
𱥹	ehnq
𱥺	ece
𱥻	eshc
𱥼	emgi
𱥽	mdhe
𱥾	emva
𱥿	eym
𱦀	erks
𱦁	eog
𱦂	eynd
𱦃	enlh
𱦄	uue
𱦅	emis
𱦆	mcwe
𱦇	ekyv
𱦈	ekqn
𱦉	emx
𱦊	eqki eqkk
𱦋	ewr
𱦌	eyk
𱦍	erno
𱦎	eycc
𱦏	eoo
𱦐	expl
𱦑	eogi
𱦒	ebmn
𱦓	ebnn
𱦔	eoe
𱦕	ore
𱦖	ehgn
𱦗	ehie
𱦘	eike
𱦙	ekud
𱦚	ekb
𱦛	emmt
𱦜	ewmu
𱦝	ell
𱦞	elae
𱦟	exc
𱦠	erck
𱦡	etyv
𱦢	enov
𱦣	eckr
𱦤	ecll
𱦥	ehse
𱦦	enw
𱦧	eode
𱦨	enbg
𱦩	eihv
𱦪	eyce
𱦫	eff
𱦬	ejx
𱦭	elst
𱦮	eynj
𱦯	esmk
𱦰	etqo
𱦱	ekcv
𱦲	edok
𱦳	ewhd
𱦴	ebce
𱦵	ebmc
𱦶	ewlt
𱦷	ehlo
𱦸	ehaf
𱦹	enfi
𱦺	ecll
𱦻	lloop
𱦼	eyvu
𱦽	ejni
𱦾	ehsf eisf
𱦿	ejns
𱧀	eioi
𱧁	evjd
𱧂	engd
𱧃	elq
𱧄	ekvv
𱧅	euou
𱧆	eeno
𱧇	sue
𱧈	ejwi
𱧉	ejbs
𱧊	emaf
𱧋	eptt
𱧌	ejtd
𱧍	eqht
𱧎	emee
𱧏	etjt
𱧐	ebcd
𱧑	ebcf
𱧒	etbq
𱧓	ewlj
𱧔	etol
𱧕	eoqg
𱧖	euf
𱧗	eldn
𱧘	ened
𱧙	llooo
𱧚	eopo
𱧛	elol
𱧜	elsi
𱧝	efdn
𱧞	eiea
𱧟	ejci
𱧠	ejhr
𱧡	ejfd
𱧢	eiov emov
𱧣	eixe
𱧤	etht
𱧥	eyjr
𱧦	efdk
𱧧	eiil
𱧨	eshu esiu esku
𱧩	essi
𱧪	esbf
𱧫	einm
𱧬	eshu
𱧭	enlv
𱧮	egwg
𱧯	eqhq
𱧰	egcf
𱧱	emnf
𱧲	gfee
𱧳	eqmv
𱧴	ebut
𱧵	etpa
𱧶	euie
𱧷	etnu
𱧸	effi
𱧹	elmw
𱧺	elcu
𱧻	etrk
𱧼	etbo
𱧽	ellb
𱧾	elpm
𱧿	ebam
𱨀	ervd
𱨁	ewle ewlf
𱨂	eavf
𱨃	exbn
𱨄	eeob
𱨅	eofu
𱨆	eiaf
𱨇	eyrb
𱨈	eifd emfd
𱨉	elbb
𱨊	emeu enru
𱨋	emkn
𱨌	ejlv
𱨍	eihb
𱨎	emjc
𱨏	ekcb ekdb
𱨐	eirc
𱨑	ewlq
𱨒	ewfb
𱨓	etwk
𱨔	ewlj
𱨕	eolf
𱨖	enwf
𱨗	enuw
𱨘	enbo
𱨙	ehos
𱨚	etgt
𱨛	eyrd
𱨜	eycu
𱨝	eitk
𱨞	ecmt elot
𱨟	eyll
𱨠	eynb
𱨡	eyvq
𱨢	eniw
𱨣	eapu
𱨤	eicf
𱨥	einm
𱨦	ekig
𱨧	ekro
𱨨	emfc
𱨩	enbt
𱨪	emgm
𱨫	emwf
𱨬	efbk
𱨭	erjw
𱨮	eawi
𱨯	etwj
𱨰	ewlq
𱨱	eahe
𱨲	eagl
𱨳	ehwn
𱨴	ekhw
𱨵	epir
𱨶	eolf
𱨷	emrm
𱨸	elsr
𱨹	efkk
𱨺	ejmc
𱨻	eycg
𱨼	eyfg
𱨽	ejgc
𱨾	ejss
𱨿	elsa
𱩀	elgo
𱩁	evet
𱩂	epdo
𱩃	edbf
𱩄	eddu
𱩅	egri
𱩆	epko
𱩇	eqfs
𱩈	eqnf
𱩉	emzs
𱩊	eibp
𱩋	eqbu
𱩌	emrj
𱩍	erre
𱩎	ewlq
𱩏	eakd
𱩐	eanf
𱩑	etla
𱩒	ewib
𱩓	eanh
𱩔	eloc
𱩕	excu
𱩖	ecyi
𱩗	euce
𱩘	eurr
𱩙	eyaf
𱩚	eytq
𱩛	efhf
𱩜	eyna
𱩝	eyca
𱩞	eell
𱩟	eujo
𱩠	egbe
𱩡	ejjs
𱩢	esoo
𱩣	edtt
𱩤	mxemz
𱩥	eavi
𱩦	eyha
𱩧	eatp
𱩨	eydo
𱩩	etrk
𱩪	etlt
𱩫	xbe
𱩬	eixi
𱩭	etaf
𱩮	eipi
𱩯	eyre
𱩰	ejbc
𱩱	egif
𱩲	embi
𱩳	eypu
𱩴	elcg
𱩵	elvk
𱩶	eanu
𱩷	enmr
𱩸	ehwb
𱩹	ehbn
𱩺	ehir
𱩻	etrg
𱩼	egrr
𱩽	emrr
𱩾	eatd
𱩿	elpc
𱪀	eauj
𱪁	etkf
𱪂	enmr
𱪃	enrr
𱪄	eipi
𱪅	eynb
𱪆	evin
𱪇	eyir
𱪈	edoa
𱪉	eixu
𱪊	eyvn
𱪋	eyub
𱪌	efwd
𱪍	eyvd
𱪎	ejtc
𱪏	etys
𱪐	eyuk
𱪑	etrr
𱪒	engr
𱪓	etsw
𱪔	eaap
𱪕	eyrf
𱪖	ejjs
𱪗	ejjs
𱪘	ebue
𱪙	eykv eynv
𱪚	ehiw
𱪛	eykv
𱪜	eykb eyvn
𱪝	eyjc
𱪞	eync
𱪟	eykq
𱪠	eync eyvn
𱪡	fo
𱪢	fks
𱪣	fsu
𱪤	fmu
𱪥	myf
𱪦	fhj
𱪧	fol
𱪨	fqj
𱪩	fmjj fmt
𱪪	fmks
𱪫	fje
𱪬	ikf
𱪭	fhk
𱪮	fpi
𱪯	fiks
𱪰	shsf
𱪱	fkm
𱪲	mxf
𱪳	flw
𱪴	fbu
𱪵	fys
𱪶	nfmv
𱪷	osf
𱪸	puf
𱪹	fnhd
𱪺	foii
𱪻	itif
𱪼	nnf
𱪽	mhsf
𱪾	fkms
𱪿	msf
𱫀	kfg
𱫁	fajj
𱫂	fsf
𱫃	bysf
𱫄	ffc
𱫅	fykl
𱫆	muf
𱫇	mfsf
𱫈	fgbn
𱫉	fryo
𱫊	ftbs
𱫋	fhap
𱫌	nwf
𱫍	fhsh
𱫎	fhjf
𱫏	fkq
𱫐	fvvo
𱫑	fqmv
𱫒	mkmif mkmmf
𱫓	sof
𱫔	mwmf
𱫕	asjf
𱫖	fthq
𱫗	fxb
𱫘	fhjm
𱫙	bff
𱫚	hif hkf
𱫛	fiyr
𱫜	fwjo
𱫝	vnf
𱫞	sif
𱫟	sfhq
𱫠	jbqf
𱫡	qif
𱫢	ihmf
𱫣	fmwp
𱫤	wsf
𱫥	auff
𱫦	fheq
𱫧	pkf
𱫨	fhqu
𱫩	ffbu
𱫪	fite
𱫫	imf
𱫬	fkyn
𱫭	vdf
𱫮	lmff
𱫯	fmlp
𱫰	qef
𱫱	grmf
𱫲	firf
𱫳	ihrf
𱫴	fwlg
𱫵	hwff
𱫶	fhwk
𱫷	foqq
𱫸	evf
𱫹	yif
𱫺	fyvw
𱫻	fstv
𱫼	uuf
𱫽	fdaf
𱫾	fsjl
𱫿	gaf
𱬀	ftjs
𱬁	ggnif
𱬂	fyuh
𱬃	fais
𱬄	fiaf
𱬅	fanr
𱬆	okf
𱬇	fnwf
𱬈	fnwk
𱬉	fiyd
𱬊	fyso
𱬋	fcwe
𱬌	fcwk
𱬍	flsu
𱬎	fyij
𱬏	fsjo
𱬐	qwf
𱬑	mdf
𱬒	fxpf
𱬓	ftre
𱬔	omaf
𱬕	fbta
𱬖	ilf
𱬗	ddf
𱬘	ffbu
𱬙	fhkn
𱬚	fnwn
𱬛	ciaf
𱬜	fyrd
𱬝	qfkd
𱬞	fmfi
𱬟	fypg
𱬠	wfwf
𱬡	ftlt
𱬢	fhxj
𱬣	ufuuu
𱬤	ddf
𱬥	cyfj
𱬦	ftwi
𱬧	xwf
𱬨	gof
𱬩	ybddf
𱬪	yfohh
𱬫	ftei
𱬬	fooo
𱬭	ftfq
𱬮	fgue
𱬯	tfibp
𱬰	xbff
𱬱	hztf
𱬲	xbfff
𱬳	ofoff
𱬴	hf
𱬵	bhun
𱬶	hopd
𱬷	bau
𱬸	holwu
𱬹	bla
𱬺	hoijb
𱬻	bygd
𱬼	byge
𱬽	ybhlo
𱬾	budi
𱬿	howln
𱭀	hoamh
𱭁	hohmj
𱭂	bbbn
𱭃	bbqok
𱭄	smbbe
𱭅	humww
𱭆	mfwi
𱭇	bwli
𱭈	xbbbe
𱭉	bewol
𱭊	ckijb
𱭋	omfb
𱭌	mbwlv
𱭍	vmx
𱭎	vmp
𱭏	vmjd
𱭐	vmmvm
𱭑	vmyhq
𱭒	vmnai
𱭓	vmobt
𱭔	vmqmw
𱭕	vmtgu
𱭖	vmyko
𱭗	lmnif
𱭘	lmloy
𱭙	llno lsno
𱭚	llbno lsbno
𱭛	lljv lsjv
𱭜	llqmo lsqmo
𱭝	llyze lsyze
𱭞	llikh lsikh
𱭟	lloar
𱭠	llytj lsytj
𱭡	llmto lsmto
𱭢	mhms
𱭣	mhmsu
𱭤	mhusu
𱭥	mhohg
𱭦	mhrhr mhrr
𱭧	mhawe
𱭨	mhavf
𱭩	hqyk
𱭪	hqslb
𱭫	hqbq
𱭬	hqom
𱭭	bnhq
𱭮	hqyhv
𱭯	hqje
𱭰	hqtbr
𱭱	hqpko
𱭲	hqfbc
𱭳	khpp
𱭴	khje
𱭵	khmui
𱭶	khymy
𱭷	khhes
𱭸	khysu
𱭹	khhpl
𱭺	khyvo
𱭻	khhqo
𱭼	khrhg khrmg
𱭽	khrok
𱭾	khtdi
𱭿	mbk
𱮀	khjnk
𱮁	tuik
𱮂	khbtu
𱮃	khoou
𱮄	khbb
𱮅	khbgr
𱮆	khlh
𱮇	khili
𱮈	khrlb
𱮉	khdkm
𱮊	khmrw
𱮋	khabt
𱮌	khhmj
𱮍	khxo
𱮎	khtmt
𱮏	khehr
𱮐	khvep
𱮑	khst
𱮒	khtod
𱮓	khtmu
𱮔	khtlq
𱮕	khokr
𱮖	khnit
𱮗	khtub
𱮘	kheog
𱮙	khyri
𱮚	khwbb
𱮛	khyhj
𱮜	khonc
𱮝	khile
𱮞	khsft
𱮟	khtkt
𱮠	kholb
𱮡	mlike
𱮢	khbta
𱮣	khyog
𱮤	fiike fiikk
𱮥	khmto
𱮦	hhwlo
𱮧	khlot
𱮨	khuok
𱮩	ibike ibikk
𱮪	mbik
𱮫	mbike
𱮬	ksp
𱮭	khtie
𱮮	khjic
𱮯	bfik
𱮰	khani
𱮱	khayv
𱮲	liyvi
𱮳	mga
𱮴	mgbk
𱮵	mgid
𱮶	mgal
𱮷	mgmmf
𱮸	mgrhu
𱮹	mgoc
𱮺	mgybo
𱮻	xnmg
𱮼	eimg
𱮽	mgihq
𱮾	mgdt
𱮿	mgqjl mgqkl
𱯀	mrmg
𱯁	yinig
𱯂	mglfd
𱯃	minim
𱯄	mgjmi
𱯅	mgyib
𱯆	mgikh
𱯇	mgeee
𱯈	mgvvu
𱯉	minzo
𱯊	mgmgb
𱯋	mgwb
𱯌	mgbw
𱯍	mgmrr
𱯎	mgikm
𱯏	gemgi
𱯐	mglf
𱯑	mdmgi
𱯒	mgwlp
𱯓	mgtbv
𱯔	mgamv
𱯕	mgwlu
𱯖	mgbmu
𱯗	mgpku
𱯘	mivi
𱯙	mgjyl
𱯚	mgytu
𱯛	mgvvf
𱯜	mggcw
𱯝	mgqmc
𱯞	mgtwa
𱯟	mgywd
𱯠	mgvpv
𱯡	mivpn
𱯢	sgytq
𱯣	mgsie
𱯤	mgyni
𱯥	mgtgo
𱯦	mghkd
𱯧	mgjmw
𱯨	mgmjk
𱯩	mgmzw
𱯪	mgxge
𱯫	mghwk
𱯬	mghbk
𱯭	bbvi
𱯮	mgffg
𱯯	mgjwv
𱯰	mgjpc
𱯱	mijmc
𱯲	mgrmd
𱯳	sgyl
𱯴	mgejl
𱯵	mgjre
𱯶	miyck
𱯷	mgnwn
𱯸	mgcxc
𱯹	mgodd
𱯺	mgjcc
𱯻	slmgi
𱯼	mgsec
𱯽	mghal
𱯾	mgnwk
𱯿	mgnak
𱰀	mgmzk
𱰁	mgxbd
𱰂	minbk
𱰃	minbk
𱰄	aqmgi
𱰅	kkhuo
𱰆	fvhio
𱰇	xwmko
𱰈	hmmun
𱰉	kimun
𱰊	ormn
𱰋	fdmun
𱰌	qlmun
𱰍	yrmun
𱰎	gemun
𱰏	ubmun
𱰐	mamun
𱰑	mnuhi
𱰒	mnnyr
𱰓	obmun
𱰔	bgmun
𱰕	ykmun
𱰖	ort
𱰗	hqmp
𱰘	hmwks
𱰙	bbhqm
𱰚	hmndt
𱰛	wsggs
𱰜	bquz
𱰝	bqjlk
𱰞	tclq
𱰟	mtbq
𱰠	takb
𱰡	ibbq
𱰢	krbb
𱰣	wcijb
𱰤	nw
𱰥	mwm
𱰦	milwl
𱰧	wpu
𱰨	lwbp
𱰩	hgw
𱰪	woy
𱰫	wyhs
𱰬	wluh
𱰭	vvw
𱰮	wosl woni
𱰯	irw
𱰰	wyoj
𱰱	wlkt
𱰲	fbmw
𱰳	ukw
𱰴	hrw
𱰵	hhww
𱰶	wmfc
𱰷	eew
𱰸	mfwv
𱰹	wyfe
𱰺	dtwks
𱰻	wvos
𱰼	wsdt
𱰽	wuice
𱰾	wshwj
𱰿	wgdr
𱱀	hwjz
𱱁	ddw
𱱂	wcwt
𱱃	suhfd
𱱄	wwuub
𱱅	ehmm
𱱆	uwbew
𱱇	nxjlk
𱱈	nxta
𱱉	kmks
𱱊	klls
𱱋	khg
𱱌	kok
𱱍	klmp
𱱎	krhu
𱱏	ktl
𱱐	kyt
𱱑	kvih
𱱒	khol
𱱓	kher
𱱔	kjmd
𱱕	kboh
𱱖	komr
𱱗	khox
𱱘	kmbi
𱱙	kqmu
𱱚	kypd
𱱛	kjsl
𱱜	kfg
𱱝	ktyu ktyv
𱱞	klit
𱱟	kbs
𱱠	kpuu
𱱡	kypr
𱱢	kibk
𱱣	ketb
𱱤	kydk
𱱥	kfdq
𱱦	kbhvd
𱱧	kghz
𱱨	kabk
𱱩	knmd
𱱪	kvtc kvhc
𱱫	kmtl
𱱬	kvdk
𱱭	kakq
𱱮	kroo
𱱯	krmi
𱱰	korb
𱱱	ktoo
𱱲	kmzt
𱱳	kcjg
𱱴	nomn
𱱵	norm
𱱶	nohhe
𱱷	nonyk
𱱸	bonok
𱱹	xnot
𱱺	hay
𱱻	haei
𱱼	haybs
𱱽	haib
𱱾	haoti
𱱿	dey
𱲀	decl
𱲁	delbk
𱲂	dev
𱲃	deob
𱲄	deluo
𱲅	deapv
𱲆	gldhe
𱲇	detpd
𱲈	logte
𱲉	demjj
𱲊	debcu
𱲋	ikbt
𱲌	rmbt
𱲍	nubt
𱲎	ghbt
𱲏	nimt
𱲐	nhqt
𱲑	nhmt
𱲒	ehbt
𱲓	gkbt
𱲔	wubt
𱲕	nfnt
𱲖	nfnt
𱲗	yznct
𱲘	qibt
𱲙	yznat
𱲚	swbt
𱲛	xfdt
𱲜	ttkoo
𱲝	yznwt
𱲞	buxt
𱲟	hzbt
𱲠	mwbt
𱲡	ytbt
𱲢	uehbt
𱲣	ihbu
𱲤	ksbu
𱲥	bunhh
𱲦	bumuu
𱲧	rmbu
𱲨	hwf
𱲩	bufo
𱲪	buyc
𱲫	buau
𱲬	wlod
𱲭	buth
𱲮	bueq
𱲯	scbu
𱲰	buve
𱲱	bufk
𱲲	ycbu
𱲳	buof
𱲴	burru
𱲵	buyfj
𱲶	ifubu mfubu
𱲷	buq
𱲸	iebu
𱲹	buryo
𱲺	buodz
𱲻	hwho
𱲼	yvahu
𱲽	budci
𱲾	bujlv
𱲿	jmmx
𱳀	bupou
𱳁	bqbu
𱳂	buhox
𱳃	buqhk
𱳄	buhqj
𱳅	busje
𱳆	hibuu
𱳇	buodj
𱳈	huqnd
𱳉	bugli
𱳊	gtyku
𱳋	buddo
𱳌	bujcr
𱳍	burxr
𱳎	bunnr
𱳏	bunlr
𱳐	bunyr
𱳑	buntr
𱳒	buiyl
𱳓	yimbu
𱳔	buslb
𱳕	luhmk
𱳖	bunsr
𱳗	bujhw
𱳘	busiu
𱳙	bunbr
𱳚	buyrk
𱳛	nzmf
𱳜	nhokr
𱳝	okmbl
𱳞	okimo okmmo
𱳟	okmbn
𱳠	oxru
𱳡	okrha
𱳢	okmws
𱳣	okmrr
𱳤	okrls
𱳥	okotf
𱳦	okesd
𱳧	okybb
𱳨	mrlis
𱳩	mrmys
𱳪	mrki
𱳫	mrjh
𱳬	kqmr
𱳭	mrtt
𱳮	mrb
𱳯	mrop
𱳰	mrq
𱳱	mrpo
𱳲	hlmr
𱳳	mrhvm
𱳴	mrmob
𱳵	mrrj
𱳶	mryvj
𱳷	mrsmt
𱳸	mrvoj
𱳹	mrfs
𱳺	mrnev
𱳻	rlbr
𱳼	mrknd
𱳽	mrykj
𱳾	mrsdi
𱳿	mrsm
𱴀	mrrui
𱴁	mrmfr
𱴂	mrdl
𱴃	mrqau
𱴄	mrdt
𱴅	yrer
𱴆	mrwe
𱴇	mrrhg mrrmg
𱴈	mrhap
𱴉	mrifm
𱴊	mrvvu
𱴋	mrshp mrskp
𱴌	mrdd
𱴍	mryk
𱴎	mrly
𱴏	mrwmi
𱴐	mrxu
𱴑	mrbcd
𱴒	mrnai
𱴓	mroot
𱴔	mrei
𱴕	mrbwm
𱴖	mryvu
𱴗	mriyr
𱴘	mrtcu
𱴙	mrtjb
𱴚	mrwb
𱴛	hfmr
𱴜	mrhag
𱴝	bmmr
𱴞	mronk
𱴟	mrfdv
𱴠	mrtgl
𱴡	mritu
𱴢	mrfdv
𱴣	mrjmp
𱴤	mrgyt
𱴥	mrjbf
𱴦	mrkrb
𱴧	grre
𱴨	mrwkp
𱴩	mrwli
𱴪	mrajv
𱴫	bemr
𱴬	mrnda
𱴭	mrmzs
𱴮	mrtmo
𱴯	mrhzd
𱴰	mritf
𱴱	mrjwp
𱴲	uemr
𱴳	mrtkt
𱴴	mrkha
𱴵	mrlgm
𱴶	mrnlm
𱴷	mrwly
𱴸	mratv
𱴹	mrmip
𱴺	mravd
𱴻	mrnuu
𱴼	mrffq
𱴽	mrybo
𱴾	mrjmh
𱴿	mrjje
𱵀	hqidr hqicr
𱵁	mrjhw
𱵂	mrqko
𱵃	mrmha
𱵄	mrbue
𱵅	mrsei
𱵆	ifhw
𱵇	ifism ifyp
𱵈	ifrni mfrnn
𱵉	ifoqo mfoqo
𱵊	ofnf
𱵋	hbtf
𱵌	ifimk mfimk
𱵍	ifgg mfgg
𱵎	ifgyo mfgyo
𱵏	iflwp mflwp
𱵐	iflwf mflwf
𱵑	ifono mfono
𱵒	ifiav mfiav
𱵓	ifyiu mfyiu
𱵔	ifssr mfssr
𱵕	ifika mfika
𱵖	ifxyo mfxyo
𱵗	abmf
𱵘	ifhay mfhay
𱵙	ifbdu mfviu
𱵚	ifsaa mfsaa
𱵛	ifrug mfrug
𱵜	ykomf
𱵝	ifbbk mfbbk
𱵞	ifogi mfogi
𱵟	iffdk mffdk
𱵠	ifecg mfecg
𱵡	ifmue mfmue
𱵢	ifqmw mfqmw
𱵣	ifrob mfrob
𱵤	ifwbr mfwbr
𱵥	iflit mflit
𱵦	ifnrw mfnrw
𱵧	ifgci mfgci
𱵨	ifytj mfytj
𱵩	ifycg mfycg
𱵪	ifnmr mfnmr
𱵫	nomrf
𱵬	ifltd mfltd
𱵭	ifsrg mfsrg
𱵮	yumf
𱵯	yumf
𱵰	ufefd
𱵱	ifxlt mfxlt
𱵲	ifcwc mfcwc
𱵳	ufjbe ufpbe
𱵴	ifmwt mfmwt
𱵵	ifgwr mfgwr
𱵶	ifffg mfffg
𱵷	ifxlt mfxlt
𱵸	afvvk
𱵹	onib
𱵺	oymb
𱵻	ootwb
𱵼	hdno
𱵽	hdhr
𱵾	hdhs hdis
𱵿	hdkr
𱶀	hdhio
𱶁	hdhmy
𱶂	hdmk
𱶃	hdrni
𱶄	hdwpd
𱶅	hdnau hdshu
𱶆	hdqd
𱶇	khkd
𱶈	hdmmb
𱶉	hzd
𱶊	hdyiu
𱶋	hnma
𱶌	hdqmo
𱶍	hdmft
𱶎	hdypn
𱶏	hdrhm
𱶐	hdtbs
𱶑	hdhsx hdnx hdshx
𱶒	hdhrj
𱶓	hdiku
𱶔	hkma
𱶕	hdgcb
𱶖	hdwke
𱶗	hdjkb
𱶘	hditi
𱶙	hdykn
𱶚	hdcrp
𱶛	hdmct
𱶜	hdhuk
𱶝	hdhkn
𱶞	hdhil
𱶟	ymhdd
𱶠	hdjkr
𱶡	jjohu
𱶢	jbnok
𱶣	yzwhd
𱶤	hdytc
𱶥	yvdmz
𱶦	hdtpd
𱶧	hduif
𱶨	ywrd
𱶩	hduwu
𱶪	hfnru
𱶫	yrrd
𱶬	hdwlf
𱶭	hdtst
𱶮	hwuuu
𱶯	hdbkz
𱶰	jcno
𱶱	jcoll
𱶲	jcyj
𱶳	jctmm
𱶴	jcliu
𱶵	jclln
𱶶	jcgp
𱶷	jctte
𱶸	jcxp
𱶹	jcbtn
𱶺	jcac
𱶻	jcni
𱶼	jcobe
𱶽	jcjjd
𱶾	jcrru
𱶿	ejch
𱷀	jcyl
𱷁	jclid
𱷂	jcsr
𱷃	jmpru jmpsu
𱷄	jcgtm
𱷅	jcdoo
𱷆	jcgho
𱷇	jchlb
𱷈	jchj
𱷉	jcvft
𱷊	jcvme
𱷋	jmyiu
𱷌	jcan
𱷍	jchqd
𱷎	jcnlg
𱷏	jcsjk
𱷐	jcjre
𱷑	jsjd
𱷒	jcobc
𱷓	jcqjk
𱷔	jcose
𱷕	jclmb
𱷖	jchqe
𱷗	jclib
𱷘	jcvme
𱷙	jctco
𱷚	jcvot
𱷛	jcfdb
𱷜	jcvff
𱷝	jcfdb
𱷞	jcfdb
𱷟	jcqdb
𱷠	jcfdb
𱷡	jcfdb
𱷢	jchdb
𱷣	mfyt
𱷤	inyt
𱷥	ytlo
𱷦	ytikk
𱷧	ytapm
𱷨	ytinz
𱷩	ytubb
𱷪	ytuqb
𱷫	osyt
𱷬	ytnoe
𱷭	ytlb
𱷮	hc
𱷯	hdh
𱷰	hmks
𱷱	hju
𱷲	hje
𱷳	ha
𱷴	hhq
𱷵	hrv
𱷶	hsoo
𱷷	hqki hqkk
𱷸	hbon
𱷹	hrlb
𱷺	hfk
𱷻	nnhok
𱷼	hslb
𱷽	hsdi
𱷾	hqse
𱷿	hdjk
𱸀	hjlv
𱸁	hgil
𱸂	hdsk
𱸃	hta
𱸄	hqbm
𱸅	hgde
𱸆	hgyi
𱸇	htbs
𱸈	hxpm
𱸉	hylo
𱸊	helw
𱸋	hndt
𱸌	hnli
𱸍	hmwv
𱸎	hie
𱸏	hzuk
𱸐	hmnj
𱸑	hmwg
𱸒	hosp
𱸓	hifm
𱸔	hvmu
𱸕	hiig
𱸖	hdtq
𱸗	hsje
𱸘	hykb
𱸙	hejl
𱸚	hfdj
𱸛	hikw
𱸜	hddg
𱸝	hgyr
𱸞	hqly
𱸟	hdsp
𱸠	howv
𱸡	hybu
𱸢	hyto
𱸣	hvhw
𱸤	hvmu
𱸥	hhyo
𱸦	hbta
𱸧	hnwa
𱸨	hnii hnri
𱸩	hitb
𱸪	hpji
𱸫	hjjd
𱸬	hqtk
𱸭	hehu
𱸮	hvdk
𱸯	hihoi
𱸰	hqau
𱸱	hhyf
𱸲	hpcz
𱸳	fd
𱸴	fdhni
𱸵	fdkq
𱸶	fdb
𱸷	fdbu
𱸸	ufdp
𱸹	fdpru fdpsu
𱸺	vefd
𱸻	fdmnn
𱸼	fdjpu
𱸽	fdwni
𱸾	fdomi
𱸿	nfnd
𱹀	fdx
𱹁	fdykl
𱹂	infd
𱹃	yzfd
𱹄	fdjwj
𱹅	mmwd
𱹆	fdfhg
𱹇	nofd
𱹈	yfnd
𱹉	fdvfh
𱹊	fdjlv
𱹋	fdtmf
𱹌	ywtd
𱹍	fdtmd
𱹎	fdrrm
𱹏	fdahm
𱹐	fdtkr
𱹑	fdhoi
𱹒	fdnbk
𱹓	ycwd
𱹔	fdsje
𱹕	fdwro
𱹖	atcd
𱹗	fdond
𱹘	fdtgp
𱹙	yfwd
𱹚	fdyhj
𱹛	fdwf
𱹜	iled
𱹝	yfwd
𱹞	fdggu
𱹟	yfwd
𱹠	yzmwd
𱹡	yfwd
𱹢	fdmwm
𱹣	gkfd
𱹤	fdytp
𱹥	mdyfe
𱹦	fdtbo
𱹧	fdild
𱹨	yrrd
𱹩	fcnem
𱹪	vfh
𱹫	vfnnz
𱹬	hkvif
𱹭	ckvif
𱹮	vfop
𱹯	vfmmf
𱹰	vfqr
𱹱	vfqms vfqys
𱹲	vfkld
𱹳	vfsdi
𱹴	vfdt
𱹵	vflsp
𱹶	vfgam
𱹷	vftob
𱹸	vfphq
𱹹	vfoot
𱹺	vfjwu
𱹻	vfmre
𱹼	vfvw
𱹽	sqff
𱹾	niff
𱹿	vfjjl
𱺀	vftvg
𱺁	vfkkr
𱺂	vfanu
𱺃	vffbg
𱺄	ckvif
𱺅	vpilp
𱺆	vfhpa
𱺇	vfhbo
𱺈	vfyrr
𱺉	vfjww
𱺊	vfdbc
𱺋	mymf
𱺌	nimf
𱺍	vfjuf
𱺎	vfyll
𱺏	vmy
𱺐	vmo
𱺑	vmnn
𱺒	vmlb
𱺓	vmhml
𱺔	vmklb
𱺕	vmikp
𱺖	vmjmn
𱺗	vmmn
𱺘	vmrup
𱺙	vmsp
𱺚	vmqr
𱺛	vmqd
𱺜	vmjt
𱺝	vmgz
𱺞	vmhgr
𱺟	vmhyu
𱺠	vmoos
𱺡	vmiav
𱺢	vmsql
𱺣	vmtbs
𱺤	vmxpm
𱺥	vmnog
𱺦	vmmwg
𱺧	vmjwf
𱺨	vmnus
𱺩	vmtgk
𱺪	vmfbg
𱺫	vmjpu
𱺬	vmhgi
𱺭	vmmzw
𱺮	vmybo
𱺯	vmtbf
𱺰	vmjbv
𱺱	oummi
𱺲	outl outtm
𱺳	ouajv
𱺴	bkkp
𱺵	wltn
𱺶	yvbk
𱺷	wliu
𱺸	wlp
𱺹	wlkn
𱺺	wlch
𱺻	wlio
𱺼	bcmun
𱺽	bkmu
𱺾	wlhu
𱺿	bcmui
𱻀	bkbs
𱻁	bcnau
𱻂	wlso
𱻃	wlhg
𱻄	bfru
𱻅	wljm
𱻆	wlvfp
𱻇	wlagi
𱻈	bklsf
𱻉	litq
𱻊	tge
𱻋	hutq
𱻌	tgmo
𱻍	tqohp
𱻎	tuvif
𱻏	tkhm
𱻐	tkss
𱻑	oqnlo
𱻒	ttmlk
𱻓	ycbtn
𱻔	tkebm
𱻕	yvwq
𱻖	sqqly
𱻗	ssmhn
𱻘	sssp
𱻙	bmss
𱻚	sskmu
𱻛	tzss
𱻜	tcss
𱻝	ssmb
𱻞	qoss
𱻟	tdss
𱻠	smmga
𱻡	mcss
𱻢	yuss
𱻣	ihss
𱻤	wqss
𱻥	hsmto
𱻦	mwss
𱻧	huqp
𱻨	qphn
𱻩	qpfm
𱻪	qpau
𱻫	qaov
𱻬	qnmc
𱻭	qqa
𱻮	qssr
𱻯	qaea
𱻰	mbmm
𱻱	hrmb
𱻲	qdv
𱻳	qdmdr
𱻴	qdqmo
𱻵	qdwim
𱻶	hdgow
𱻷	sjysm
𱻸	sjhs
𱻹	grsj
𱻺	sjoms
𱻻	sjonp
𱻼	sjtl sjttm
𱻽	sjbmm
𱻾	sjwtp
𱻿	melq
𱼀	ni
𱼁	bnh
𱼂	bmy
𱼃	boso
𱼄	wlob
𱼅	bjlk
𱼆	bgpd
𱼇	bopj
𱼈	boa
𱼉	bbuc
𱼊	knwb
𱼋	biav
𱼌	bebn
𱼍	bdbm
𱼎	bal
𱼏	blmo
𱼐	bcst
𱼑	ipf
𱼒	bvmg
𱼓	bhoo
𱼔	bihs
𱼕	bmui
𱼖	bpmz
𱼗	bfvl
𱼘	hbhmu
𱼙	bybg
𱼚	gdihb
𱼛	obrru
𱼜	bsrl
𱼝	btmt
𱼞	bihp
𱼟	lbjmo
𱼠	lbwls
𱼡	boor
𱼢	btwi
𱼣	bhro
𱼤	byvg
𱼥	ybsqf
𱼦	ykobo
𱼧	lsll
𱼨	huxu
𱼩	miq
𱼪	mgw
𱼫	abmg
𱼬	mgomd
𱼭	xg
𱼮	xgmu
𱼯	fdx
𱼰	xlbb
𱼱	xchhg
𱼲	gxgxt
𱼳	hronr
𱼴	hrqoj
𱼵	oqtmd
𱼶	hyru
𱼷	hyx
𱼸	hyhnk
𱼹	hykt
𱼺	hyopj
𱼻	hyeee
𱼼	hygwg
𱼽	hyafu
𱼾	hyfoo
𱼿	djoby
𱽀	usohy
𱽁	vihby
𱽂	hytmb
𱽃	holi
𱽄	hyssg
𱽅	htmue
𱽆	hyrmt
𱽇	meav
𱽈	hpav
𱽉	nufd
𱽊	nuyra
𱽋	tf
𱽌	tti
𱽍	tdi
𱽎	tbo
𱽏	tpi
𱽐	thnq
𱽑	tmgi
𱽒	tmms
𱽓	tl
𱽔	tahu
𱽕	trsh
𱽖	tlwl
𱽗	tys
𱽘	too
𱽙	tot
𱽚	thvd
𱽛	tml
𱽜	tqki tqkk
𱽝	tmg
𱽞	uuku
𱽟	tdhn
𱽠	tobo
𱽡	tcob
𱽢	thnn
𱽣	topj
𱽤	tyth
𱽥	tfd
𱽦	tjdi
𱽧	tshm
𱽨	tqjl tqkl
𱽩	tqau
𱽪	twmu
𱽫	tejb
𱽬	tepi
𱽭	tct
𱽮	thog
𱽯	tpor
𱽰	tonh
𱽱	tiie
𱽲	tywr
𱽳	tron
𱽴	tmbn
𱽵	tmft
𱽶	trkr
𱽷	tlet
𱽸	tpad
𱽹	thou
𱽺	tohi
𱽻	tbw
𱽼	teyt
𱽽	tehu
𱽾	tvma
𱽿	tnlq
𱾀	tdhr
𱾁	ttfd
𱾂	tgrv
𱾃	tbuf
𱾄	tlkt
𱾅	tkho
𱾆	tkng
𱾇	tpmgb
𱾈	teaj
𱾉	tyqn
𱾊	tysv
𱾋	tifu
𱾌	tnht
𱾍	tllt
𱾎	tgrm
𱾏	tsik
𱾐	ttjs
𱾑	tjdhe
𱾒	twgg
𱾓	twgf
𱾔	twqv
𱾕	uuavh
𱾖	togr
𱾗	toyk
𱾘	tkhu tkhv
𱾙	tmcu
𱾚	tkrv
𱾛	truon
𱾜	tsoo
𱾝	tdog
𱾞	tqii
𱾟	tawi
𱾠	tyni
𱾡	tbsa
𱾢	tnwa
𱾣	lstwb
𱾤	tmmt
𱾥	tqho
𱾦	lmpd
𱾧	ttwt
𱾨	tyav
𱾩	tqjt
𱾪	fvto
𱾫	tegj
𱾬	tkgse
𱾭	tmjg
𱾮	trapv
𱾯	twle
𱾰	thda
𱾱	tuse
𱾲	uuhbo
𱾳	tmzr
𱾴	tehg
𱾵	tdhe
𱾶	tuwf
𱾷	hetmh
𱾸	tyig
𱾹	tnqs
𱾺	tbvmd
𱾻	togg
𱾼	trbb
𱾽	twft
𱾾	thdo
𱾿	teyx
𱿀	tgso
𱿁	nttjr
𱿂	twbz
𱿃	tvfw
𱿄	tche
𱿅	tmoo
𱿆	tift
𱿇	txle
𱿈	svtaa
𱿉	tayv
𱿊	tggg
𱿋	tntab
𱿌	tddl
𱿍	tftgu tftqu
𱿎	yphs
𱿏	kiypn kiypu
𱿐	ynnhe yunhe
𱿑	mwypn
𱿒	rshyu
𱿓	ydcms
𱿔	glypn glypu
𱿕	rnhfd
𱿖	ybikk
𱿗	ynynn
𱿘	lism
𱿙	lino
𱿚	limks
𱿛	mkui
𱿜	lip
𱿝	lioe
𱿞	litm
𱿟	limbl
𱿠	litk
𱿡	liuni
𱿢	liip
𱿣	lijru
𱿤	lirhr
𱿥	ofli
𱿦	owyi
𱿧	lilsa
𱿨	ddli
𱿩	liytt
𱿪	ligsr
𱿫	lifbr
𱿬	lithq
𱿭	lihom
𱿮	eeli
𱿯	limfx
𱿰	liqr
𱿱	juliy
𱿲	litlj
𱿳	limad
𱿴	dnli
𱿵	litpr
𱿶	licst
𱿷	lihml
𱿸	liysd
𱿹	lijhu
𱿺	liyt
𱿻	fdki
𱿼	litgb
𱿽	liwlx
𱿾	ojli
𱿿	lickn
𲀀	liykb
𲀁	limui
𲀂	ligcw
𲀃	liubb
𲀄	liypm
𲀅	libx
𲀆	liysk
𲀇	ylli
𲀈	liipc
𲀉	litzh
𲀊	limnb
𲀋	xili
𲀌	iogi
𲀍	liayn
𲀎	tbnii
𲀏	siyhr
𲀐	lissg
𲀑	hijci
𲀒	liyga
𲀓	libwi
𲀔	nahi
𲀕	lifff
𲀖	litme
𲀗	hvslt
𲀘	hbtv
𲀙	httmd
𲀚	htnhu
𲀛	holbn
𲀜	hovin
𲀝	hokqn
𲀞	hoyjn
𲀟	hojkn
𲀠	hoppn
𲀡	hogfn
𲀢	hobbn
𲀣	hotin
𲀤	lmn
𲀥	oyv
𲀦	ldh
𲀧	mvhv
𲀨	lmfm
𲀩	lw
𲀪	lyyhs
𲀫	loqo
𲀬	lom
𲀭	yyhv
𲀮	lss
𲀯	ymvv
𲀰	mhyhv
𲀱	rhyhv
𲀲	lrau
𲀳	lono
𲀴	lgl
𲀵	ltbc
𲀶	ylov
𲀷	suuv
𲀸	lhmg
𲀹	lhlb
𲀺	lyzk
𲀻	lmhf
𲀼	lmnf
𲀽	ltyu ltyv
𲀾	lbx
𲀿	lgsk lqsk
𲁀	lbof
𲁁	lyyr
𲁂	litd
𲁃	jbmrv
𲁄	lhuu
𲁅	yvgv
𲁆	llx
𲁇	ltke
𲁈	looo
𲁉	mwhg mwmg
𲁊	mgkn
𲁋	mgmmu
𲁌	mwtub
𲁍	mwhhk
𲁎	jdiu
𲁏	fubuu
𲁐	buhqc
𲁑	mfbu
𲁒	buhml
𲁓	buuu
𲁔	msbhu
𲁕	grbhu
𲁖	tbhu
𲁗	ycbhu
𲁘	yabhu
𲁙	ysbhu
𲁚	nbmnr
𲁛	nbir
𲁜	mknbg
𲁝	bvnbg
𲁞	nband
𲁟	imnbq
𲁠	nbsei
𲁡	yrdh
𲁢	yrhj
𲁣	yryv
𲁤	yrik
𲁥	yrsk
𲁦	irsm
𲁧	yrmx
𲁨	ninr
𲁩	yrig
𲁪	yrmgn
𲁫	yrumg
𲁬	yrhom
𲁭	yrioi
𲁮	hnymr
𲁯	kdymr
𲁰	yrnum
𲁱	yimd
𲁲	yrmue
𲁳	yryrv
𲁴	yrmhv
𲁵	yrfvl
𲁶	yrmri
𲁷	yrlii
𲁸	yrigj
𲁹	yikhp
𲁺	yrybb
𲁻	yrjjy
𲁼	yrbmp
𲁽	yrhbs
𲁾	yrlii
𲁿	yrfsf
𲂀	yrtgi
𲂁	iggr
𲂂	iuhni
𲂃	iuei
𲂄	iummi
𲂅	iunhe
𲂆	iuwl
𲂇	iujmn
𲂈	iumbl
𲂉	iuml
𲂊	iuopj
𲂋	iuwd
𲂌	iuleg
𲂍	iuymr
𲂎	iumha
𲂏	iuqv
𲂐	iujbl
𲂑	iuabt
𲂒	iual
𲂓	iutwa
𲂔	iuitf
𲂕	iuitc
𲂖	iuyto
𲂗	iuvvv
𲂘	orcor
𲂙	jicor
𲂚	ylcor
𲂛	jrjgr
𲂜	jgcor
𲂝	mtfq
𲂞	gtnor
𲂟	gtnor
𲂠	gtiof gtmof
𲂡	momdr
𲂢	nobhf
𲂣	yopuu
𲂤	bsgb
𲂥	bsopd
𲂦	bsndt
𲂧	bswww
𲂨	bcop
𲂩	hsbc isbc msbuc
𲂪	bcjz
𲂫	livvc
𲂬	bcph
𲂭	rrbuc
𲂮	bcqd
𲂯	bcjnd
𲂰	bcyaj
𲂱	bchss
𲂲	bcapv
𲂳	bchjg
𲂴	lcmfj
𲂵	nucsc
𲂶	suokc
𲂷	wctak
𲂸	bcjic
𲂹	wcyrk
𲂺	vvbo
𲂻	bobho
𲂼	bohml
𲂽	boyc
𲂾	bojr
𲂿	bomnr
𲃀	livvo
𲃁	bofq
𲃂	boiyr
𲃃	bose
𲃄	odbo
𲃅	bofdv
𲃆	lomfj
𲃇	gzxhu
𲃈	gztlt
𲃉	gosm
𲃊	gohlo
𲃋	gosp
𲃌	gorhu
𲃍	gobv
𲃎	gohdn
𲃏	goqmo
𲃐	gulp
𲃑	gotor
𲃒	godlo
𲃓	goibk goybk
𲃔	rxpn
𲃕	fryo
𲃖	rxsm
𲃗	mfro
𲃘	rxiku
𲃙	rxlll rxlls
𲃚	rxslb
𲃛	rxlw
𲃜	rxhym
𲃝	rxwdh
𲃞	rxkd
𲃟	rxomi
𲃠	rxyhv
𲃡	rxbkq
𲃢	rxhby
𲃣	rxhbv
𲃤	rxifu
𲃥	rxsoy
𲃦	rxyks
𲃧	rxip
𲃨	rxrhr
𲃩	rxtmi
𲃪	rxyki
𲃫	rxqmo
𲃬	rxhrn
𲃭	rxjlk
𲃮	rxjcm
𲃯	rxlsi
𲃰	rxmwg
𲃱	rxppa
𲃲	rxmre
𲃳	rxrrr
𲃴	tiho
𲃵	rxybr
𲃶	rxopo
𲃷	rxbam
𲃸	rxflb
𲃹	rxehu
𲃺	rxllo
𲃻	mnrh
𲃼	quro
𲃽	rxtqp
𲃾	rxhhu
𲃿	rxywv
𲄀	rxyfd
𲄁	rxlaz
𲄂	rxyhj
𲄃	rxhqb
𲄄	rxmzm
𲄅	yodo
𲄆	qlryo
𲄇	rxgtv
𲄈	rxmwf
𲄉	rxjca
𲄊	mkryo
𲄋	baryo
𲄌	rxtbn
𲄍	rxtlt
𲄎	rxjhw
𲄏	rxyyw
𲄐	rxvfd
𲄑	tslo
𲄒	rxmkg
𲄓	rxyrs
𲄔	rxyrk
𲄕	rxtgv
𲄖	rxoiu
𲄗	nhsh
𲄘	hhmg
𲄙	hhmks
𲄚	hhpo
𲄛	hhau
𲄜	hhha
𲄝	fshsh
𲄞	hhof
𲄟	hhoqo
𲄠	hhgz
𲄡	hhrau
𲄢	hhjcs
𲄣	hhdoo
𲄤	hhqmb
𲄥	hhcso
𲄦	hhog
𲄧	hhfdv
𲄨	hhneq
𲄩	hhibi hhiji
𲄪	hhfbu
𲄫	hhonv
𲄬	hhxpf
𲄭	hhykb
𲄮	hhjsc
𲄯	hhtgi
𲄰	hhhtz
𲄱	hhshr
𲄲	hhfbf
𲄳	jjik
𲄴	ysjwj
𲄵	jjomj
𲄶	jjhkl
𲄷	jjjlo
𲄸	jjhnd
𲄹	jjtl jjttm
𲄺	bjice
𲄻	xjwr
𲄼	jjyub
𲄽	jjyjr
𲄾	jjseo
𲄿	hujwj
𲅀	kqqs
𲅁	kqpi
𲅂	kqsd
𲅃	cccq
𲅄	ylh
𲅅	ytgm
𲅆	ylss
𲅇	sgytq
𲅈	hljr
𲅉	slmhx
𲅊	mvomd
𲅋	yno
𲅌	yf
𲅍	hoov
𲅎	ynvm
𲅏	yno
𲅐	yqni
𲅑	ybo
𲅒	yop
𲅓	yklb
𲅔	yhi
𲅕	yhjx
𲅖	ydhe
𲅗	yybo
𲅘	yhbu
𲅙	yvmi
𲅚	ymwl
𲅛	yoyt
𲅜	ybm
𲅝	yioj
𲅞	yipj
𲅟	yqhl
𲅠	yahl
𲅡	yoot
𲅢	ybcd
𲅣	yjlw
𲅤	yjcs
𲅥	ysjr
𲅦	ywlt
𲅧	yal
𲅨	ylwe
𲅩	yhqj
𲅪	yhoi
𲅫	ytul
𲅬	yorf
𲅭	yysv
𲅮	yybl
𲅯	yols
𲅰	yoah
𲅱	ytqb
𲅲	yshf
𲅳	yvmw
𲅴	ymeg
𲅵	ymae
𲅶	yxgl
𲅷	yhgi
𲅸	yhhc
𲅹	yhew
𲅺	yhlb
𲅻	yhhz
𲅼	yoar
𲅽	ffykq
𲅾	yuf
𲅿	yytg
𲆀	ymwc
𲆁	ypuz
𲆂	yhef
𲆃	yhed
𲆄	yorr
𲆅	ffyjj
𲆆	yvfg
𲆇	yltj
𲆈	ymzu
𲆉	wlol
𲆊	yytg
𲆋	ybbl
𲆌	yhuc
𲆍	hoydw
𲆎	tvysq
𲆏	pinl
𲆐	mbvnl
𲆑	mtnl
𲆒	gysnl
𲆓	ftnl
𲆔	sfnl
𲆕	tmrnl
𲆖	rmbnl
𲆗	ptdnl
𲆘	vvscl
𲆙	todnl
𲆚	lcqnl
𲆛	ruuru
𲆜	ofrau
𲆝	krcnl
𲆞	lerau
𲆟	gzgzl
𲆠	sldtq
𲆡	rsteu
𲆢	twinl
𲆣	biyul
𲆤	vfvfl
𲆥	mwmhn
𲆦	mwni
𲆧	mwno
𲆨	mwoj
𲆩	mwci
𲆪	mwor
𲆫	mwpa
𲆬	mwss
𲆭	mwqki
𲆮	mgmwu
𲆯	eumcw
𲆰	mwaph
𲆱	mwbb
𲆲	mwptd
𲆳	mwrrr
𲆴	mwbw
𲆵	mwmvi
𲆶	mwpuu
𲆷	mwllt
𲆸	mwofb
𲆹	mwyrw
𲆺	mwtzg
𲆻	mwanp
𲆼	mwwli
𲆽	mwtwb
𲆾	hhwew
𲆿	ckcmw tktcw
𲇀	hdshu
𲇁	nfwg
𲇂	wgpg
𲇃	agtbs
𲇄	hgatv
𲇅	cti
𲇆	omso
𲇇	chqu
𲇈	cedi
𲇉	crf
𲇊	cmcw
𲇋	cmbl
𲇌	cqhp
𲇍	lec
𲇎	cmgt
𲇏	clsa
𲇐	cdln
𲇑	boc
𲇒	ctlj
𲇓	cyzn
𲇔	sec
𲇕	clit
𲇖	buc
𲇗	ctev
𲇘	ctvs
𲇙	chuk
𲇚	cnbp
𲇛	ctgp
𲇜	ceoy
𲇝	cwhr
𲇞	cwfu
𲇟	cjpu
𲇠	cyrj
𲇡	cxpf
𲇢	crru
𲇣	ctpd
𲇤	case
𲇥	ctyj
𲇦	rnc ruc
𲇧	cype
𲇨	ckod
𲇩	teec
𲇪	cjhb
𲇫	cnog
𲇬	cami
𲇭	opdh
𲇮	opysm
𲇯	opu
𲇰	opsh
𲇱	opje
𲇲	opqni
𲇳	ophul
𲇴	opp
𲇵	opee
𲇶	opsk
𲇷	opkd
𲇸	oprup
𲇹	opmnn
𲇺	opsmg
𲇻	opkld
𲇼	opmbl
𲇽	opgp
𲇾	opmkb
𲇿	opomc
𲈀	opofm
𲈁	opgc
𲈂	opymf
𲈃	opirm
𲈄	opqmo
𲈅	oplp
𲈆	opfbr
𲈇	opckl
𲈈	oppfd
𲈉	opjmi
𲈊	opse
𲈋	opjrb
𲈌	opkg
𲈍	opsjl
𲈎	opjmm
𲈏	opybn
𲈐	opfd
𲈑	opnis
𲈒	opafu
𲈓	optod
𲈔	ophwi
𲈕	opjjn
𲈖	opmui
𲈗	opytj
𲈘	optgt
𲈙	opmwd
𲈚	opayf
𲈛	opytg
𲈜	opcwa
𲈝	oprxr
𲈞	oprrd
𲈟	opypt
𲈠	opynv
𲈡	optrg
𲈢	jbsie
𲈣	olyv
𲈤	posm
𲈥	hvpo
𲈦	mhsn
𲈧	anbh
𲈨	anbt
𲈩	anbnh
𲈪	annn
𲈫	anykq
𲈬	anhsl
𲈭	anne
𲈮	anhag
𲈯	anirm
𲈰	anyvw
𲈱	anyjj
𲈲	angim
𲈳	anlqq
𲈴	lqan
𲈵	lse
𲈶	lsbhu
𲈷	lsee
𲈸	lsng
𲈹	lsmcw
𲈺	lsfmu
𲈻	lsohg
𲈼	lshjd
𲈽	lsmdr
𲈾	yqlis
𲈿	yks
𲉀	lslsh
𲉁	lstcu
𲉂	lsggi
𲉃	lstkr
𲉄	lsumt
𲉅	lsilr
𲉆	lstmk
𲉇	tklst
𲉈	sflst
𲉉	nlop
𲉊	nlyc
𲉋	nlymy
𲉌	nlha
𲉍	nlir
𲉎	nlmam
𲉏	nllq
𲉐	hvqd
𲉑	nlkme
𲉒	rvsdh
𲉓	nlbmy
𲉔	hrbb
𲉕	rtsbb
𲉖	rvdoo
𲉗	nljtd
𲉘	nlbcn
𲉙	hvwbb
𲉚	risd
𲉛	risqh
𲉜	nlgge
𲉝	nloar
𲉞	nlsav
𲉟	nlwlk
𲉠	nbg
𲉡	rusqb
𲉢	nrsjl
𲉣	nlisk
𲉤	nrywt
𲉥	nlypg
𲉦	nrmrr
𲉧	shog
𲉨	kuog
𲉩	ogee
𲉪	shrog
𲉫	oefh
𲉬	lgno
𲉭	ssogk
𲉮	mzog
𲉯	ygjbl
𲉰	mznh
𲉱	mbfb
𲉲	mziuj
𲉳	mzmf
𲉴	mzph
𲉵	mzqki mzqkk
𲉶	mzoik
𲉷	mzoii
𲉸	mzrj
𲉹	msjp
𲉺	mzii
𲉻	mzsjl
𲉼	mzwd
𲉽	mzkho
𲉾	mzhog
𲉿	mzetm
𲊀	mzjbm
𲊁	mzapi
𲊂	mzgzi
𲊃	mbfk
𲊄	mugr
𲊅	mzold
𲊆	mzyrs
𲊇	mzid
𲊈	mzeao
𲊉	mzefu
𲊊	mzobp
𲊋	mzygq
𲊌	mzorg
𲊍	mzatk
𲊎	mzroo
𲊏	mzeka
𲊐	mbeqa
𲊑	milgi
𲊒	mzyre
𲊓	mijbo
𲊔	mzpom
𲊕	qbon
𲊖	bdqmb
𲊗	qbhdh
𲊘	qblit
𲊙	lyhhi
𲊚	tvmws
𲊛	tjme
𲊜	jrtj
𲊝	tjhno
𲊞	tjjce
𲊟	tjiop tjmop
𲊠	tjetk
𲊡	tjang
𲊢	dqop
𲊣	dqabu
𲊤	dqneq
𲊥	qsl
𲊦	yklsm
𲊧	yahbr
𲊨	oryta
𲊩	yjnor
𲊪	mzmx
𲊫	llmz
𲊬	psumz
𲊭	mznmu
𲊮	jhpmz
𲊯	wmgmz
𲊰	ypumz
𲊱	axmz
𲊲	xhumz
𲊳	gttmz
𲊴	qamz qiamz
𲊵	ajvmz
𲊶	orrmz
𲊷	arxmz
𲊸	tznzz
𲊹	eimbo
𲊺	mxmbo
𲊻	mrmbo
𲊼	gzmbo
𲊽	cgmbo
𲊾	tvmbo
𲊿	almbo
𲋀	fvmbo
𲋁	ovmbo
𲋂	qambo
𲋃	ipmbo
𲋄	hnq
𲋅	hnice
𲋆	hnihr
𲋇	oblq
𲋈	hnob
𲋉	hnnyr
𲋊	hnobp
𲋋	hkyou hqyon
𲋌	hnsit hnsmt
𲋍	hntbu
𲋎	kihnk
𲋏	hnhqu
𲋐	hnikp
𲋑	hnle
𲋒	lpnoo
𲋓	funoi
𲋔	oinj oink osnj osnk
𲋕	oihd oshd
𲋖	veoav
𲋗	mnoav
𲋘	oijpu osjpu
𲋙	oileg
𲋚	oiobt
𲋛	mzoav
𲋜	oippa osppa
𲋝	oittc osttc
𲋞	oiqlb
𲋟	oitit ostit
𲋠	oiypo osypo
𲋡	oiiwf osiwf
𲋢	nuyk
𲋣	nuhd
𲋤	nushr
𲋥	nuhbv
𲋦	nutbs
𲋧	nufbr
𲋨	nuppa
𲋩	nuqmf
𲋪	oulit
𲋫	nutct
𲋬	nuybu
𲋭	aothu
𲋮	hadl
𲋯	hairm
𲋰	hadw
𲋱	hacmt hatct
𲋲	hatoe
𲋳	sfpp
𲋴	sfhe sfme
𲋵	bsqf
𲋶	sfise
𲋷	sftco
𲋸	sfmfe
𲋹	sfgz
𲋺	sfmre
𲋻	smbo
𲋼	sfcrp
𲋽	sfgrv
𲋾	hiosf
𲋿	sfjwi
𲌀	sfvff sfvfy
𲌁	sftzl
𲌂	sfiip
𲌃	sftgi
𲌄	smy
𲌅	smosl
𲌆	smjru
𲌇	krsm
𲌈	smyrf
𲌉	smsjr
𲌊	smtgr
𲌋	smnot
𲌌	bbki
𲌍	bbive
𲌎	bbnhd
𲌏	bbrme bbse
𲌐	bbobv bbobn
𲌑	bbil
𲌒	bbywm
𲌓	bbyco bbyto
𲌔	bbfvk
𲌕	bbdtc
𲌖	ksyb
𲌗	ybyiu
𲌘	yllwv
𲌙	ybrre
𲌚	shr
𲌛	shohg shomg
𲌜	shgpm
𲌝	shrsn
𲌞	shlsd
𲌟	shog
𲌠	shcsp
𲌡	shgcr
𲌢	shtmb
𲌣	shyog
𲌤	jbupe
𲌥	bwli
𲌦	jcpi
𲌧	hwhf
𲌨	hiok
𲌩	hibuc
𲌪	hiwjr
𲌫	bvhwi
𲌬	hilsy
𲌭	humfg
𲌮	hiyrf
𲌯	hahid
𲌰	hibsu
𲌱	nfmys
𲌲	nfyc
𲌳	lknf
𲌴	nfmgb
𲌵	moof
𲌶	gnfok
𲌷	nfwks
𲌸	nfpou
𲌹	nfkkb
𲌺	nfvjr
𲌻	nfmee
𲌼	nfsmg
𲌽	nfgim
𲌾	nfyuh
𲌿	nfhwp
𲍀	nfhyr
𲍁	nfytu
𲍂	yfnwf
𲍃	nftqr
𲍄	nfupo
𲍅	nkrsk
𲍆	nmpn
𲍇	nmik
𲍈	nmyv
𲍉	mcnwm
𲍊	nmhq
𲍋	nmyc
𲍌	nmjr
𲍍	einwm
𲍎	nmtc
𲍏	nmhgu
𲍐	nmfd
𲍑	nmjpu
𲍒	nmihs
𲍓	nmmlh
𲍔	nmefh
𲍕	nmhwj
𲍖	nmal
𲍗	nmbme
𲍘	nmjjn
𲍙	nmnjk
𲍚	hzg
𲍛	puhz
𲍜	hzci
𲍝	hzmob
𲍞	jbhz
𲍟	dddhz
𲍠	hzjbd
𲍡	hzydi
𲍢	hzrj
𲍣	mlvhz
𲍤	bachz
𲍥	hgobz
𲍦	hzwlc
𲍧	tvfhz
𲍨	sohz
𲍩	hzwww
𲍪	wzhz
𲍫	clhym
𲍬	hmsm
𲍭	tuhym
𲍮	yshym
𲍯	hmij
𲍰	nfhym
𲍱	oshym
𲍲	srhym
𲍳	kbhym
𲍴	pjhym
𲍵	xphm
𲍶	oiem
𲍷	ddhym
𲍸	fbhym
𲍹	rdhym
𲍺	jihym
𲍻	lshm
𲍼	ekhym
𲍽	aahym
𲍾	oghym
𲍿	ykhym
𲎀	tkhym
𲎁	mihym
𲎂	oehym
𲎃	wfhym
𲎄	ebhym
𲎅	edlm
𲎆	hmytg
𲎇	xvhym
𲎈	hmtbo
𲎉	irhym
𲎊	ywykl
𲎋	ipf
𲎌	iprme
𲎍	ipnwf
𲎎	iplpc
𲎏	jooe
𲎐	dedoe dedoi
𲎑	qeykq
𲎒	qeyok
𲎓	qegsk
𲎔	icww
𲎕	litlc lltwc
𲎖	hiwff iiwff
𲎗	jzwff
𲎘	wfjcz
𲎙	wlbux
𲎚	mgte
𲎛	gtjet
𲎜	gewd
𲎝	xvsk
𲎞	xvskr
𲎟	xvnzd
𲎠	xvjav
𲎡	hthuh
𲎢	xucor
𲎣	gexuo
𲎤	gixuo gkxuo ghxuo
𲎥	ymxuw
𲎦	kvxu
𲎧	xuhne
𲎨	xuor
𲎩	xugce
𲎪	xuase
𲎫	xuhuo
𲎬	yuohh
𲎭	yuhem
𲎮	nuyj
𲎯	uoorb
